NO ./textures/walls/tex-one.xpm
SO ./textures/walls/tex-one.xpm
EA ./textures/walls/tex-two.xpm
WE ./textures/walls/tex-two.xpm

F	58 , 59 , 63
C	89 , 91 , 90

111111111111111111111111111111
100000000000011100000000000001
101111111110010001011111111101
100000000010010001000000000001
100000000010010001000000000001
101111111110010001011111111101
100000000000000000000000000001
100000001111111111111000000001
100000001000000000001000000001
100000001000001000001000000001
101111001000001000001000111111
10000000100S001000000000000001
111110001000001000001000011111
100000001000001000001000000001
100000001000000000001000000001
111111111111111111111111111111

