NO ./textures/walls/bonus-one.xpm
SO ./textures/walls/bonus-one.xpm
EA ./textures/walls/bonus-two.xpm
WE ./textures/walls/bonus-two.xpm

F	128,128,128

C	228,228,228

        11111111111111111111111111
        10000000001100000000000001
        10110000011100000000001011
        1001000000D000000000001D11
1111111110110000011101000000001011
1000000D000000000111D111111111111
11101111111111011111010011111
111D111011111110100000010011111
111010011101010000000000000011
10100000D00000001100001010011
1010100111111111111001101010011
110N100111010101111101111000111
11110111 1110111 101111010001
11111111 1111111 111111111111
