111111111111111
10C111111C00001
100000011000001
10E00000000C001
1000000P0001101
111100001111111
111111111111111