11111111111
1C000P00001
10100011101
101010C01C1
10101011101
1E111010001
100C1011101
1C0000C0001
11111111111