1111111111111111
1CC0000P000000C1
1001000001111001
100100100C001001
10010C1001111001
1E01111001000001
1000C010011110C1
1C0000000C000001
1111111111111111