1111111111
1P0C000001
1111111C11
11011E0011
1111111111